WWWWWWWWWWWWWWWWWWWWWWWWWWWWWWWWWWWWWWWWWWWWWWWWWWWWWWWWWWWWWWWWW
W---------------------------------------------------------------W
W------------------------------WWW------------------------------W
W---------------------------------------------------------------W
W----------------------------------WWWWWWWWWWWWWWWWWWWWWWWWWWWWWW
WWW-----------WWWW-----------------W
W----------------------------------W
W----------------------------------WWWWWWWWWWWWWWWWWWWWWWWWWWWWWW
W---------------------------------------------------------------W
W---------------------------------------------------------------W
W--------P-------------------------WWWWWWWWWWWWWWWWWWWWWWWWWWWWWW
W---WWWWWWWWWWWWWWWWWWWWWWWWWWWW---W
W----------------------------------W
W----------------------------------WWWWWWWWWWWWWWWWWWWWWWWWWWWWWW
W------------WWW------------------------------------------------W
W------------------------------------------------------------C--W
WWWWWWWWWWWWWWWWWWWWWWWWWWWWWWWWWWWWWWWWWWWWWWWWWWWWWWWWWWWWWWWWW