WWWWWWWWWWWWWWWWWWWWWWWWWWWWWWWWWWWWWWWWWWWWWWWWWWWWWWW
W---P---W-------C-----------------------------W-------W
W--------W--------------------------------------------W
W---------W-------------------------------------------W
W----------W-------------------------------W----------W
W-----------WWWWWWWWWWWWWWWWWWWWWWWWWWWWWWWW----------W
W-----------------------------------------------------W
WWWWWWW-----------------------------------------------W
W------------WWWWWWWW---------------------------------W
WWWWWWWW----------------------------------------------W
W-----------------------------------------------------W
WWWWWWWWWWWWWWWWWWWWWWWWWWWWWWWWWWWWWWWWWWWWWWWWWWWWWWW