WWWWWWWWWWWWWWWWWWWWWWWWWWWWWWWWWWWW
WP---------------------------------W
W----------------------------------W
WWWWWWWWWWWWWWWWWW-----------------W
W----------------------------------W
W----------------------------------W
W--------------------WWWWWWWWWWWWWWW
W----------------------------------W
W----------------------------------W
W---WWWWWWWWWWWWWWWWWWWWWWWWWWWW---W
W--W----------------------------W--W
W--W----------------------------W--W
W----------------------------------W
W--C-------------------------------W
WWWWWWWWWWWWWWWWWWWWWWWWWWWWWWWWWWWW